Английский - EN - what should I do?
Азербайджанский - AZ - mən nə?
Армянский - AM - ինչ ես անում?
Белорусский - BE - што мне рабіць?
Болгарский - BG - Какво трябва да направя ?
Боснийский - BS  - Šta da radim ?
Венгерский - HU - Mit kell tennem ?
Вьетнамский - VI - Tôi nên làm gì ?
Голландский - NL - Wat moet ik doen ?
Греческий - EL - Τι πρέπει να κάνω ;
Грузинский - KA - რა უნდა გავაკეთო?
Датский - DA - Hvad skal jeg gøre ?
Иврит - HE - מה עליי לעשות ?
Ирландский - GA - Cad ba cheart dom a dhéanamh ?
Исландский - IS - Hvað ætti ég að gera ?
Испанский - ES - ¿Qué debo hacer ?
Итальянский - IT - Che cosa devo fare ?
Казахский - KK - маған не істеу керек?
Китайский - ZH - 我該怎麼辦？
Корейский - KO - 어떻게해야합니까?
Латинский - LA - quid me vis facere ?
Латышский - LV - Ko man darīt ?
Литовский - LT - Ką turėčiau daryti?
Македонский - MK - Што треба да направам ?
Монгольский - MN - Би юу хийх ёстой вэ?
Немецкий - DE - Was kann ich tun?
Непальский - NE - म के गर्नुपर्छ ?
Норвежский - NO - Hva bør jeg gjøre ?
Персидский - FA - باید چه کار کنم ؟
Польский - PL - Co należy zrobić ?
Португальский - PT - O que devo fazer ?
Румынский - RO - Ce ar trebui să fac ?
Русский - RU - что мне делать ?
Сербский - SR - Шта да радим ?
Словацкий - SK - Čo mám robiť ? 
Словенский - SL - Kaj naj storim ?
Сомали - SO - Maxaan sameeyaa ?
Таджикский - TG - Чӣ бояд кард ?
Тайский - TH - สิ่งที่ฉัน ควรทำอย่างไร?
Турецкий - TR - Ne yapmalıyım ?
Узбекский - UZ - nima qilay?
Украинский - UK - що мені робити?
Урду - UR - مجھے کیا کرنا چاہیے ؟
Французский - FR - Que dois-je faire?
Хорватский - HR - Što da radim ?
Чешский - CS - Co mám dělat ?
Эстонский - ET - Mida ma peaksin tegema ?
Японский - JA - 私は何をすべきでしょうか？
